0	0	0	0	0	0	0	0	0	0	0	0	0	0	0	0	0	0	0	0	0	0
0	0	0	0	0	0	0	0	0	0	0	0	0	0	0	0	0	0	0	0	0	0
0	0	0	0	0	0	0	0	1	11	1	0	0	0	0	0	0	0	0	0	0	0
0	0	0	0	0	0	0	0	1	-1	1	0	0	0	0	0	0	0	0	0	0	0
0	0	1	1	1	0	0	0	1	1	1	0	13	0	13	0	0	0	0	0	0	0
0	0	12	1	1	0	0	0	0	1	0	0	1	0	1	0	0	0	0	0	0	0
0	0	12	1	1	1	6	1	1	1	1	1	1	1	1	0	0	0	0	0	0	0
0	0	1	1	1	0	0	0	0	1	0	0	0	0	0	0	0	0	0	0	0	0
0	0	0	0	0	0	0	0	0	6	0	0	10	10	10	0	0	0	0	0	0	0
0	0	0	0	0	0	0	0	0	1	0	0	1	1	1	0	0	0	0	0	0	0
0	0	0	0	0	0	0	0	0	1	0	0	0	1	0	0	0	0	0	0	0	0
0	0	1	1	1	0	0	0	4	1	8	0	0	1	0	0	1	1	5	0	0	0
0	0	1	2	-5	1	6	1	1	-3	1	1	6	1	1	1	1	-2	5	0	0	0
0	0	1	1	1	0	0	0	4	1	4	0	0	0	0	0	1	1	5	0	0	0
0	0	0	0	0	0	0	0	0	1	0	0	0	0	0	0	0	0	0	0	0	0
0	0	0	0	0	0	0	0	0	6	0	0	0	0	0	0	0	0	0	0	0	0
0	0	0	0	0	0	0	0	0	1	0	0	0	0	0	0	0	0	0	0	0	0
0	0	0	0	0	0	0	0	0	1	0	0	0	0	0	0	0	0	0	0	0	0
0	0	0	0	0	0	0	0	3	1	3	0	0	0	0	0	0	0	0	0	0	0
0	0	0	0	0	0	0	0	3	-4	3	0	0	0	0	0	0	0	0	0	0	0
0	0	0	0	0	0	0	0	3	1	3	0	0	0	0	0	0	0	0	0	0	0
0	0	0	0	0	0	0	0	0	0	0	0	0	0	0	0	0	0	0	0	0	0
0	0	0	0	0	0	0	0	0	0	0	0	0	0	0	0	0	0	0	0	0	0
